xxxxxxxxxxxxxxxxxxxx
x..................x
x..................x
x..................x
x....P.............x
x....R.............x
x....RRRRRRRRRR....x
x..............R...x
x..............R...x
xxxxxxxxxxx....R...x
x.........x....R...x
x.........x....R...x
x...GR....x....R...x
x.....R...x....R...x
x......R..x..RRR...x
x.......R....R.....x
x........RRRR......x
x..................x
x..................x
xxxxxxxxxxxxxxxxxxxx