xxxxxxxxxxxxxxxxxxxx
x.........x........x
x.........x....G...x
x.........x........x
x....P....x........x
x.........x........x
x.........x........x
x.........x........x
x.........x........x
x.........x........x
x.........x........x
x..................x
x..................x
x..................x
x..................x
x..................x
x..................x
x..................x
xxxxxxxxxxxxxxxxxxxx