xxxxxxxxxxxxxxxxxxxx
x..................x
x..................x
x..................x
x....P.............x
x..................x
x..................x
x..................x
x....R.............x
x..................x
x..................x
x....R...xxxxxxxxxxx
x........x.........x
x........x.........x
x.....R..x.....G...x
x..................x
x........R.........x
x..................x
x..................x
xxxxxxxxxxxxxxxxxxxx